Goal 2,2 4,3 
A 1,0 3,1 
B 3,0 5,1 
C 0,1 2,2 
D 2,1 4,2 
E 4,1 5,4 
F 5,1 6,4 
G 0,2 1,5 
H 1,2 2,5 
I 2,3 3,5 
J 3,3 4,5 
K 4,4 6,5 
L 1,5 3,6 
M 3,5 5,6 