Goal 2,2 4,3 
A 0,0 3,1 
B 3,0 4,2 
C 4,0 5,3 
D 0,1 1,3 
E 1,1 3,2 
F 0,3 2,4 
G 2,3 3,5 
H 1,4 2,6 
I 4,4 6,5 
J 2,5 4,6 
K 4,5 6,6 