Goal 1,2 3,3 
A 0,0 2,1 
B 3,0 6,1 
C 3,1 4,3 
D 4,1 6,2 
E 0,2 1,4 
F 5,2 6,5 
G 2,3 3,6 
H 3,3 5,4 
I 0,4 2,5 
J 3,5 6,6 