Goal 1,2 3,3 
A 0,0 2,1 
B 2,0 3,2 
C 3,0 4,3 
D 0,1 1,4 
E 1,3 4,4 
F 3,5 6,6 