Goal 3,2 5,3 
A 2,0 5,1 
B 5,0 6,3 
C 2,1 3,3 
D 3,1 5,2 
E 3,2 5,3 
F 2,3 3,5 
G 3,3 4,5 
H 4,3 6,4 
I 4,4 6,5 
J 2,5 5,6 