Goal 1,2 3,3 
A 0,0 2,1 
B 5,0 6,3 
C 0,1 1,4 
D 3,1 4,4 
E 0,4 1,6 
F 4,4 6,5 
G 2,5 5,6 