Goal 0,2 2,3 
A 2,0 3,3 
B 3,0 5,1 
C 5,0 6,3 
D 3,1 4,3 
E 0,3 1,5 
F 1,3 4,4 
G 1,4 3,5 
H 3,4 4,6 
I 4,4 5,6 
J 0,5 2,6 