Goal 0,2 2,3 
A 0,0 1,2 
B 3,0 6,1 
C 1,1 4,2 
D 4,1 5,4 
E 5,1 6,4 
F 2,2 3,4 
G 3,2 4,4 
H 0,3 2,4 
I 3,4 4,6 
J 4,4 6,5 
K 1,5 3,6 