Goal 0,2 2,3 
A 1,0 2,2 
B 2,0 3,3 
C 4,0 6,1 
D 0,3 1,5 
E 1,3 3,4 
F 3,3 5,4 
G 5,3 6,6 
H 1,4 3,5 
I 3,4 4,6 
J 4,4 5,6 
K 0,5 3,6 