Goal 1,2 3,3 
A 0,0 2,1 
B 2,0 3,2 
C 4,0 6,1 
D 0,1 2,2 
E 5,1 6,4 
F 0,2 1,5 
G 4,2 5,4 
H 1,3 4,4 
I 1,4 2,6 
J 3,4 4,6 
K 4,4 6,5 
L 4,5 6,6 