Goal 3,2 5,3 
A 0,0 2,1 
B 2,0 4,1 
C 4,0 5,2 
D 2,1 3,3 
E 5,1 6,4 
F 1,2 2,4 
G 3,3 5,4 
H 0,3 1,6 
I 3,4 4,6 
J 4,4 6,5 
K 1,5 3,6 
L 4,5 6,6 