Goal 1,2 3,3 
A 0,0 2,1 
B 3,0 4,3 
C 5,0 6,2 
D 0,1 1,4 
E 4,1 5,4 
F 5,2 6,4 
G 1,3 4,4 
H 0,4 1,6 
I 4,4 6,5 
J 4,5 6,6 