Goal 0,2 2,3 
A 0,0 1,2 
B 3,0 6,1 
C 3,1 4,3 
D 5,1 6,4 
E 4,2 5,4 
F 0,3 3,4 
G 3,3 4,5 
H 2,4 3,6 
I 4,4 6,5 
J 0,5 2,6 
K 3,5 5,6 