Goal 2,2 4,3 
A 0,0 3,1 
B 3,0 4,2 
C 4,0 5,3 
D 5,0 6,3 
E 0,1 1,3 
F 1,1 3,2 
G 0,3 2,4 
H 2,3 3,5 
I 1,4 2,6 
J 4,4 6,5 
K 2,5 4,6 
L 4,5 6,6 