Goal 0,2 2,3 
A 0,0 1,2 
B 1,0 3,1 
C 2,1, 3,4 
D 5,0 6,3 
E 3,3 6,4 
F 4,4 5,6 
G 0,5 3,6 