Goal 1,2 3,3 
A 2,0 3,2 
B 3,0 6,1 
C 0,1 1,3 
D 3,1 4,4 
E 4,1 6,2 
F 1,3 2,5 
G 4,3 6,4 
H 0,4 1,6 
I 2,4 4,5 
J 5,4 6,6 
K 1,5 4,6 