Goal 0,2 2,3 
A 0,0 1,2 
B 3,0 6,1 
C 2,1 5,2 
D 5,1 6,4 
E 0,2 2,3 
F 2,2 3,4 
G 3,2 4,4 
H 4,2 5,4 
I 0,3 2,4 
J 3,4 4,6 
K 4,4 6,5 
L 1,5 3,6 