Goal 2,2 4,3 
A 0,0 2,1 
B 2,0 3,2 
C 4,1 6,2 
D 0,2 1,4 
E 1,2 2,4 
F 4,2 5,4 
G 5,2 6,4 
H 2,3 4,4 
I 2,4 3,6 
J 4,4 6,5 
K 0,5 2,6 