Goal 1,2 3,3 
A 0,0 1,3 
B 1,0 3,1 
C 3,0 4,3 
D 2,3 3,5 
E 3,3 6,4 
F 5,4 6,6 
G 2,5 5,6 