Goal 2,2 4,3 
A 2,0 3,2 
B 3,0 5,1 
C 1,1 2,3 
D 0,2 1,4 
E 4,2 5,4 
F 1,3 3,4 
G 0,4 3,5 
H 4,4 5,6 
I 0,5 2,6 