Goal 1,2 3,3 
A 0,0 1,3 
B 3,0 4,3 
C 2,3 3,5 
D 3,3 6,4 
E 5,4 6,6 
F 2,5 5,6 