Goal 0,2 2,3 
A 0,0 2,1 
B 2,0 3,3 
C 3,0 4,2 
D 4,0 6,1 
E 0,3 1,5 
F 1,3 3,4 
G 3,3 5,4 
H 5,3 6,6 
I 3,4 4,6 
J 0,5 2,6 