Goal 1,2 3,3 
A 3,2 4,5 
B 1,3 3,4 
C 5,3 6,6 
D 1,4 2,6 
E 2,5 4,6 