Goal 0,2 2,3 
A 3,0 4,2 
B 4,0 6,1 
C 1,1 3,2 
D 4,1 5,3 
E 2,2 3,4 
F 3,2 4,4 
G 0,3 2,4 
H 4,3 6,4 
I 0,4 1,6 
J 2,4 5,5 
K 5,4 6,6 
L 3,5 5,6 