Goal 1,2 3,3 
A 0,0 1,2 
B 3,0 4,3 
C 4,0 6,1 
D 4,1 6,2 
E 0,2 1,4 
F 2,3 3,5 
G 3,3 5,4 
H 5,3 6,6 
I 0,4 2,5 
J 0,5 3,6 